1111111111111111
1P010C000000C111
10011001100000C1
10000C000111C001
1111111111111111
100000C0000E0001
10000CCC00000001
10000000000C00E1
1111111111111111