1111111111111111
1P010C000000C111
10011001100000C1
10000C000111C001
1000000000000001
100000C000000001
10000CCC00000001
10000000000C00E1
1111111111111111