1111111111111111
1P000C000000C111
100010E1100000C1
10100C000111C001
1C100000C0000001
1111111111111111