1111111111111111
1P010C000000C001
1000011101110C11
100E0C0C0111C001
1111111111111111