1111111111111111111
1P000C000000C000001
1001111111111111101
1001C1C1C1C1C1C1101
1C000000000000000E1
100C1C1C1C1C1C1C1C1
1111111111111111111