1111111111111111
1P010C000000C111
10011001100000C1
10000C000111C001
1000111111000001
100000C001111101
1111111100111001
10000C0CEC0C0001
1111111111111111